
NO ./path_to_the_north_texture
SO ./path_to_the_south_texture
WE ./path_to_the_west_texture
EA ./path_to_the_east_texture

F 255,255,0
C 55,255,128

11111111111111111111
10000001000000000001
10000000100000000111
10000000001000000001
10000000000100000001
10000000000010000001
10000000000001000001
10000000000000100001
10N00001000000010001
11111111111111111111